tab tab tab tab tab tab tab tab tab tab tab tab tab tab cut cut tab tab tab tab
tab non non non non non non non non non non non non non non non non non non tab
tab non non non non non non non non non non non non non non non non non non tab
tab non non tab non non tab non non non non non non tab non non tab non non tab
tab non non tab non non tab non non non non non non tab non non tab non non tab
tab non non tab non non tab tom non non non non dou tab non non tab non non tab
tab non non tab non non tab dou non non non non che tab non non tab non non tab
tab non non tab non non tab non non non non non non tab non non tab non non tab
tab non non tab non non tab non non non non non non tab non non tab non non tab
tab non non non non non non non non non non non non non non non non non non tab
tab non non non non non non non non non non non non non non non non non non tab
tab tab tab tab cut cut tab tab tab tab tab tab tab tab tab tab tab tab tab tab
